
C 80,		80,70

NO ./textures/bluestone.xpm    
SO ./textures/purplestone.xpm  
EA ./textures/wood  planks_w.XPM       	


WE textures/redbrick.xpm   
R 					  2800 2600
S textures/heart_s.xpm		
F 30,30,  30


 1111111111111111111           111                                                
111000000000200000001           101
100001002011120000111           101
100000022220000000101           111
1000000202000W0000101           1
 1111100000001111111           11
 1111111111111111111           11
1111
11111111111111111111111111111111111111111111       1
11111111111111111111111111111111111111111111111111101
11111111111111111111111111111111111111111111111111111





